00011100000102
01000001112101
01111111111101
00000000000001
00002111111111
00000000003121
00111111111101
00000000000001
10101011111111
